На букву А
Август – величественный, великий, священный

Августин – летний

Авдей – служитель бога Яхве, священнослужитель

Авенир – грядущий, будущий

Аверкий – обращающий в бегство

Аверьян – обращающий в бегство, непобедимый

Авксентий – чужой ксенос, растущий

Аврор, Аврорий – сын утренней зари

Автоном – самостоятельный, сам себе закон

Агап – любимый

Агафон – добродетельный, благородный

Аггей – торжественный, праздничный, веселящийся

Адам – созданный из праха земного

Адонис – владыка

Адриан – сильный, зрелый

Азарий – помощь Божья

Аким – утверждение, Воскресение Господне

Алевтин – чуждый дурного

Александр – защитник людей

Алексей – защитник

Альберт – мудрый

Альбин – белый

Альфред – хороший советник

Амвросий – принадлежащий бессмертным, божественный

Амос – нагруженный, несущий ношу

Ананий – отмеченный милостью Божьей

Анастасий – воскресший

Анатолий – восточный

Андрей – мужественный, храбрый

Андриан – мужественный, храбрый

Андрон – мужественный, храбрый

Андроник – победитель мужей

Аникей – исторически сложившееся имя

Аникита – непобедимый

Анис, Анисий – сладко пахнущий

Анисим – исполнение, завершение

Антип – противник

Антон, Антоний – вступающий в бой

Антонин – добрый

Антуан – иноязычное прочтение Антона

Аполлинарий – сын солнца

Аполлон – бог солнца

Аргент – серебряный

Арефий – жизненный

Аристарх – глава лучших

Аркадий – пастух или Житель Аркадии

Арсен – мужественный

Арсений – мужественный, возвышенный

Артем – безупречное здоровье

Артём, Артемий – невредимый

Артемий – невредимый, здоровый

Артур – большой как медведь

Архип – начальник над конями

Аскольд – золотой голос

Атеист – не верующий

Афанасий – бессмертный

Афиноген – потомок Афины

На букву Б
Бажен – желанный, любимый

Бенедикт – благословенный

Богдан – данный богом

Боеслав – прославленный в бою

Болеслав – большая слава

Боримир – борющийся за мир

Борис – борец, воин

Борислав – борющийся за славу

Боян – боец, буйный

Бронислав – славный защитник

Будимир – миролюбивый

Булат – крепкий

На букву В
Вадим – сеющий смуту

Валентин – сильный, здоровый

Валерий – быть сильным, здоровым

Валерьян – быть сильным, здоровым

Вальтер – управляющий людьми

Варфоломей – сын Толмая

Василий – царский

Василько (нар. от Василий) – царевич

Вацлав – большая слава

Велимир – повелитель мира

Велислав – прославленный

Велор, Велорий – состоятельный

Венедикт – благословенный

Вениамин – сын десницы (правой руки), любимый сын

Викентий – победитель

Виктор – победитель

Викторин – победитель.

Вилен – сокращение от В.И.ЛЕНин

Виссарион – лесной человек

Виталий – жизненный

Витольд – лесной властитель

Влад – владеющий

Владилен – аналогично ВЛАДИмир ЛЕНин

Владимир – владеющий миром

Владислав – владеющий славой

Владлен – аналогично ВЛАДимир ЛЕНин

Влас – вялый, неповоротливый

Воин – воин

Воислав – прославленный в войне

Володар (старослав.) – владыка

Вольдемар, Вальдемар – знаменитый властитель

Вольмир, Волемир – повелитель мира

Всеволод – властелин всего народа

Всемил (славв.) – всем мил

Вячеслав – не раз прославившийся

На букву Г
Гавриил, Гаврила, Гаврило, Гаврил – божественный воин

Гаврила – божественный воин

Галактион – звездный

Гарри, Гаррий – терпимый

Гедеон – воин

Гелиан, Гелий – солнечный

Гений – гений

Геннадий – родовитый

Георгий – земледелец

Герасим – почтенный

Герман – родной

Гертруд – ГЕРой ТРУДа

Читайте также

«Красивые мужские имена»
Подробнее
Глеб – большой, высокий

Горимир – светлый мир

Горислав – светлая слава

Гранит – твердый

Григорий – не спящий

Гурий – львёнок

На букву Д
Давид – любимый

Давыд, Давид – любимый

Дамир – миролюбивый

Дан – бог луны

Даниил, Данила, Данило, Данил – Божий суд

Данила – Бог

Дар – дар

Декабрий – зимний

Дементий – укрощающий, усмиряющий

Демид – мысль Зевса

Демьян – покоряющий

Денис (нар. от стар. Дионисий) – бог жизненных сил природы

Джеральд – иное прочтение Гаральда

Джозеф – иное прочтение Жозефа, Иосифа, Осипа

Джон – иное прочтение Ивана

Дионисий, Дионис – бог растительности

Дмитрий, Димитрий – бог плодородия

Добрыня – добрый молодец

Дональт – властелин мира

Донат – крепкий

Дорофей – Божий дар

На букву Е
Евгений – благородный

Евграф – благонаписанный, благоначертанный

Евдоким – хорошо прославленный

Евлампий – лучезарный

Евсей – благочестивый

Евстафий – устойчивый

Евстигней – добрый знак

Елизар – Бог помог

Елисей – спасённый Богом

Емельян – льстивый

Епифан – видный, знатный

Еремей – возвышенный Богом

Ермил – лес

Ермолай – народ и Гермес

Ерофей – освящён от Бог

Еруслан – лев

Ефим – благочестивый

Ефрем – плодовитый

На букву Ж
Ждан – ждущий

На букву З
Захар – Божья память

Зиновий – Зевсова сила

Зорий – утренний

Зосима – собирающийся в путь

На букву И
Ибрагим – иное прочтение Абрама, Авраама, Аврома

Игнатий, Игнат – неведомый

Игорь – защитник бога

Измаил – услышит Бог

Изот – дающий жизнь, животворный

Изяслав – добывший славу

Илларион – веселый, радостный

Илья – крепость Господня

Иннокентий – невинный, непорочный

Иосиф – Божия награда

Ипат – высочайший

Ипатий – высочайший

Ипполит – распрягающий коня

Ираклий – героем прославленный

Исай – спасение

Исидор, Сидор – покровитель плодородия

Июлий – летний

На букву К
Каллистрат – прекрасный воин

Капитон – голова

Карп – плод

Касьян (нар. от стар. Кассиан) – пустой

Киприан – уроженец Кипра или медный

Кир – господин

Кирилл – владыка

Клавдий – хромой или из рода Клавдиев

Клемент – милостивый

Клементий – господин, владыка

Клим – виноградная лоза

Климент, Клим – снисходительный

Климентий, Клементий (нар. от Климент) – кроткий

Колумбий – голубь

Кондрат – четырехугольный

Кондратий – воин, несущий копьё

Константин – стойкий, постоянный

Корней – рог или ягода кизила

Корнил – рог

Корнилий – ягода кизила

Кузьма, Козьма (нар. от стар. Косма) – украшенный

Куприян (нар. от Киприан) – уроженец Кипра или медный

На букву Л
Лавр – знаменитый

Лаврентий – увенчанный лаврами

Ладислав – хорошая слава

Лазарь – Божья помощь

Ларион (нар. от Иларион) – радостный

Лев – лев

Леон – лев

Леонард – сильный

Леонид – сын льва

Читайте также

«Флирт с мужчиной: секреты обольщения»
Подробнее
Леонтий – львиный

Лонгин – длинный

Лука – счастье

Лукьян, Лукиан – счастливый

Лучезар – светящийся, лучезарный

Любим – красавец

Люксен, Люциан – светлый

На букву М
Маврикий – черный

Май – теплое сердце

Майслав, Маеслав – прославившийся в мае

Макар, Макарий – счастливый

Макс – величавый

Максим – величавый

Максимильян, Максимилиан – величавый

Мариан – море

Марк – молоток

Мартын – посвященный Марсу, воинственный

Матвей – божий человек

Мефодий – следящий, разыскивающий

Мечислав – славный меч

Милан – милый

Милен – милый

Милий – милый

Милонег – милый

Милослав – слава мила

Мина – месячный, лунный

Мирон – добрый

Митрофан – найденный матерью

Михаил, Михайло – равный Богу

Михей – равный Богу

Модест – скромник

Моисей – извлеченный из воды

Мокий – насмешник

Монолит – незыблемый

Мстислав – славный мститель

На букву Н
Назар, Назарий – посвященный Богу

Натан – дарованный

Наум – утешение

Неон – блистающий

Неонил – принципиальный

Нестор, Нестер – возвратившийся на родину

Никандр – победитель мужчин

Никанор – увидевший победу

Никита – побеждать

Никифор – победоносный

Никодим – победа и народ

Николай – победа народа

Никон – Победоносец

Нифонт – разумный, рассудительный

Норд – север(ный)

На букву О
Овидий – спаситель

Одиссей – сердитий

Октавиан – восьмой

Октябрин – осенний

Октябрь – осенний

Олег – святой

Олимпий – название священной горы Олимп

Онисим – исполнение, завершение

Онуфрий – свободный

Орест – дикарь

Оскар – Божье копьё

Остап – устойчивый

На букву П
Павел – маленький

Палладий – посвященный Афине Палладе

Панкрат – сильнейший, всесильный

Панфил – любящий всех

Парамон – надежный, верный

Парфем – девственный, чистый

Пахом – широкоплечий

Пересвет – светлый

Петр – камень, скала

Пётр – скала или камень

Пимен – пастух, пастырь

Платон – широкоплечий

Поликарп – плодоносный

Порфирий – пурпурный, багряный

Потап – овладевший

Прокл – слава его опережает

Прохор – руководитель хора

На букву Р
Радий – радий

Радислав – рад славе

Радомир – рад миру

Ратибор – воин

Ратмир – защищающий мир

Родион – песнь владыке

Роман – римский; римлянин

Ростислав – возрастающая слава

Рубен – рубиновый, краснеющий

Руслан – лев

Рюрик – слава короля

На букву С
Савва, Сава – желанный

Савватий – субботний

Савелий – желанный

Самсон – солнечный

Самуил – имя Божье, Бог услышал

Свет – свет

Светлан – светлый

Светослав – слава светла

Святогор – святая гора

Святополк – святой полк

Севастьян – высокочтимый

Север – север

Северин – холодный

Северьян, Севериан – северный

Северян – северный

Селиван – лесной

Семен – услышанный

Семён (нар. от стар. Симеон) – услышанный Богом в молитве

Серафим – пламенный

Сергей – высокочтимый

Сидор – дар Изиды

Сила – лесной, дикий

Сильвестр – лесной

Симон – услышанный

Сократ – сохраняющий власть

Соломон – мирный

Софрон – здравомыслящий, благоразумный

Спартак – организатор, руководитель

Спиридон – кузовок

Сталь, Сталий – твердый

Станимир – миротворец

Степан, Стефан – венок

Стоян – сильный

На букву Т
Тарас – беспокойный

Твердислав – твердая слава

Творимир – творит мир

Теймураз – аналог Тимуру

Терентий – трущий, потёртый

Тимофей – Бога почитающий

Тимур – железный

Тит – честь, почёт

Тихон – удачный

Тристан – грустный (tristia)

Трифон – изнеженный

Трофим – питомец

На букву У
Ульян – принадлежащий Юлию

Устин – справедливый

Читайте также

«Женские татарские имена»
Подробнее
На букву Ф
Фаддей – подарок Бога

Фадей, Фаддей – похвала

Февралин – зимний

Федор – Божий дар

Федосий – дар богов

Федот – данный богами

Феликс – преуспевающий

Феоктист – созданный Богом

Феофан – явление Бога

Ферапонт – ученик, слуга

Филарет – любитель добродетели

Филимон – любимый

Филипп – любящий лошадей

Флорентий – цветущий

Флорентин – расцветающий

Флоренц – цветущий

Флорин – цветущий

Фока – тюлень

Фома – близнец

Фортунат – счастливый

Фотий – светлый, светящийся

Фрол (нар. от стар. Флор) – цветущий

На букву Х
Харитон – благодетель

Харлампий – радостный свет

Храбр – храбрый

Христоф – несущий Христа

Христофор – исповедующий веру Христову

На букву Ч
Чеслав – честь и слава

На букву Э
Электрон – янтарь

Эльбрус – гора

Эмиль – усердный

Эммануил – с нами Бог

Энергий – энергичный

Эраст – прелестный

Эрнст – серьезный, строгий

На букву Ю
Ювеналий (стар. от Иувеналий) – юный

Юджин – благородный

Юлиан (стар. от Иулиан) – кудрявый

Юлий (стар. от Иулий) – пушистый

Юпитер – юпитер

Юрий (стар., нар. от Георгий) – земледелец

На букву Я
Яков (стар. от Иаков) – подражающий Богу

Якуб – следующий

Януарий (стар. от Ианнуарий) – январский

Яромир – солнечный мир

Ярополк – солнечный
Ярослав – горящая слава или славящий Ярилу, древнеславянского бога